RibbonChampionKalos	卡洛斯冠军
RibbonChampionG3	冠军 (3代)
RibbonChampionSinnoh	神奥冠军
RibbonBestFriends	好友
RibbonTraining	修行
RibbonBattlerSkillful	高手对战
RibbonBattlerExpert	大师对战
RibbonEffort	努力
RibbonAlert	振奋
RibbonShock	心跳
RibbonDowncast	失望
RibbonCareless	大意
RibbonRelax	畅快
RibbonSnooze	酣睡
RibbonSmile	欢笑
RibbonGorgeous	豪华
RibbonRoyal	高贵
RibbonGorgeousRoyal	豪华高贵
RibbonArtist	肖像
RibbonFootprint	脚印
RibbonRecord	纪录
RibbonLegend	传说
RibbonCountry	地区
RibbonNational	国家
RibbonEarth	地球
RibbonWorld	世界
RibbonClassic	经典
RibbonPremier	纪念
RibbonEvent	活动
RibbonBirthday	生日
RibbonSpecial	特殊
RibbonSouvenir	回忆
RibbonWishing	许愿
RibbonChampionBattle	对战冠军
RibbonChampionRegional	地区冠军
RibbonChampionNational	国家冠军
RibbonChampionWorld	世界冠军
RibbonCountMemoryContest	华丽大赛回忆奖章
RibbonCountMemoryBattle	对战回忆奖章
RibbonChampionG6Hoenn	丰缘冠军 (6代)
RibbonContestStar	华丽大赛之星
RibbonMasterCoolness	帅气大师
RibbonMasterBeauty	美丽大师
RibbonMasterCuteness	可爱大师
RibbonMasterCleverness	聪明大师
RibbonMasterToughness	强壮大师
RibbonG3Cool	帅气 (G3)
RibbonG3CoolSuper	帅气超级
RibbonG3CoolHyper	帅气专家
RibbonG3CoolMaster	帅气大师
RibbonG3Beauty	美丽 (G3)
RibbonG3BeautySuper	美丽超级
RibbonG3BeautyHyper	美丽专家
RibbonG3BeautyMaster	美丽大师
RibbonG3Cute	可爱 (G3)
RibbonG3CuteSuper	可爱超级
RibbonG3CuteHyper	可爱专家
RibbonG3CuteMaster	可爱大师
RibbonG3Smart	聪明 (G3)
RibbonG3SmartSuper	聪明超级
RibbonG3SmartHyper	聪明专家
RibbonG3SmartMaster	聪明大师
RibbonG3Tough	强壮 (G3)
RibbonG3ToughSuper	强壮超级
RibbonG3ToughHyper	强壮专家
RibbonG3ToughMaster	强壮大师
RibbonG4Cool	帅气 (G4)
RibbonG4CoolGreat	帅气超级
RibbonG4CoolUltra	帅气究极
RibbonG4CoolMaster	帅气大师
RibbonG4Beauty	美丽 (G4)
RibbonG4BeautyGreat	美丽超级
RibbonG4BeautyUltra	美丽究极
RibbonG4BeautyMaster	美丽大师
RibbonG4Cute	可爱 (G4)
RibbonG4CuteGreat	可爱超级
RibbonG4CuteUltra	可爱究极
RibbonG4CuteMaster	可爱大师
RibbonG4Smart	聪明 (G4)
RibbonG4SmartGreat	聪明超级
RibbonG4SmartUltra	聪明究极
RibbonG4SmartMaster	聪明大师
RibbonG4Tough	强壮 (G4)
RibbonG4ToughGreat	强壮超级
RibbonG4ToughUltra	强壮究极
RibbonG4ToughMaster	强壮大师
RibbonWinning	成功
RibbonVictory	胜利
RibbonAbility	才能
RibbonAbilityGreat	超级才能
RibbonAbilityDouble	双人才能
RibbonAbilityMulti	多人才能
RibbonAbilityPair	组队双打才能
RibbonAbilityWorld	世界才能
RibbonCountG3Cool	帅气
RibbonCountG3Beauty	美丽
RibbonCountG3Cute	可爱
RibbonCountG3Smart	聪明
RibbonCountG3Tough	强壮
RibbonChampionAlola	阿罗拉冠军
RibbonBattleRoyale	皇家大师
RibbonBattleTreeGreat	高手对战树
RibbonBattleTreeMaster	大师对战树
RibbonChampionGalar	伽勒尔冠军奖章
RibbonTowerMaster	对战塔大师奖章
RibbonMasterRank	级别对战大师奖章
RibbonMarkLunchtime	正午之证
RibbonMarkSleepyTime	午夜之证
RibbonMarkDusk	黄昏之证
RibbonMarkDawn	拂晓之证
RibbonMarkCloudy	阴云之证
RibbonMarkRainy	降雨之证
RibbonMarkStormy	落雷之证
RibbonMarkSnowy	降雪之证
RibbonMarkBlizzard	暴雪之证
RibbonMarkDry	干燥之证
RibbonMarkSandstorm	沙尘之证
RibbonMarkMisty	浓雾之证
RibbonMarkDestiny	命运之证
RibbonMarkFishing	上钩之证
RibbonMarkCurry	咖喱之证
RibbonMarkUncommon	偶遇之证
RibbonMarkRare	未知之证
RibbonMarkRowdy	淘气之证
RibbonMarkAbsentMinded	无虑之证
RibbonMarkJittery	紧张之证
RibbonMarkExcited	期待之证
RibbonMarkCharismatic	领袖之证
RibbonMarkCalmness	冷静之证
RibbonMarkIntense	热情之证
RibbonMarkZonedOut	疏忽之证
RibbonMarkJoyful	幸福之证
RibbonMarkAngry	愤怒之证
RibbonMarkSmiley	微笑之证
RibbonMarkTeary	悲伤之证
RibbonMarkUpbeat	爽快之证
RibbonMarkPeeved	激动之证
RibbonMarkIntellectual	理性之证
RibbonMarkFerocious	本能之证
RibbonMarkCrafty	狡猾之证
RibbonMarkScowling	凶悍之证
RibbonMarkKindly	优雅之证
RibbonMarkFlustered	动摇之证
RibbonMarkPumpedUp	昂扬之证
RibbonMarkZeroEnergy	倦怠之证
RibbonMarkPrideful	自信之证
RibbonMarkUnsure	自卑之证
RibbonMarkHumble	木讷之证
RibbonMarkThorny	不纯之证
RibbonMarkVigor	活力之证
RibbonMarkSlump	不振之证
RibbonHisui	洗翠的样子
RibbonTwinklingStar	闪亮之星奖章
RibbonChampionPaldea	帕底亚冠军奖章
RibbonMarkJumbo	大个子之证
RibbonMarkMini	小不点之证
RibbonMarkItemfinder	捡拾之证
RibbonMarkPartner	搭档之证
RibbonMarkGourmand	美食之证
RibbonOnceInALifetime	千载难逢奖章
RibbonMarkAlpha	头目之证
RibbonMarkMightiest	最强之证
RibbonMarkTitan	宝主之证