RibbonChampionKalos	칼로스챔피언리본
RibbonChampionG3	챔피언리본 (Gen3)
RibbonChampionSinnoh	신오챔피언리본
RibbonBestFriends	절친리본
RibbonTraining	수행리본
RibbonBattlerSkillful	그레이트배틀리본
RibbonBattlerExpert	마스터배틀리본
RibbonEffort	노력리본
RibbonAlert	뚝심리본
RibbonShock	철렁리본
RibbonDowncast	풀죽기리본
RibbonCareless	덜렁이리본
RibbonRelax	상쾌리본
RibbonSnooze	잠보리본
RibbonSmile	방글방글리본
RibbonGorgeous	고저스리본
RibbonRoyal	로열리본
RibbonGorgeousRoyal	고저스로열리본
RibbonArtist	브로마이드리본
RibbonFootprint	발자국리본
RibbonRecord	레코드리본
RibbonLegend	레전드리본
RibbonCountry	컨트리리본
RibbonNational	내셔널리본
RibbonEarth	어스리본
RibbonWorld	월드리본
RibbonClassic	클래식리본
RibbonPremier	프리미어리본
RibbonEvent	이벤트리본
RibbonBirthday	버스데이리본
RibbonSpecial	스페셜리본
RibbonSouvenir	메모리얼리본
RibbonWishing	위시리본
RibbonChampionBattle	배틀챔피언리본
RibbonChampionRegional	에리어챔피언리본
RibbonChampionNational	내셔널챔피언리본
RibbonChampionWorld	월드챔피언리본
RibbonCountMemoryContest	추억콘테스트리본
RibbonCountMemoryBattle	추억배틀리본
RibbonChampionG6Hoenn	호연챔피언리본 (ORAS)
RibbonContestStar	콘테스트스타리본
RibbonMasterCoolness	근사함마스터리본
RibbonMasterBeauty	아름다움마스터리본
RibbonMasterCuteness	귀여움마스터리본
RibbonMasterCleverness	슬기로움마스터리본
RibbonMasterToughness	강인함마스터리본
RibbonG3Cool	쿨리본 (G3)
RibbonG3CoolSuper	쿨리본슈퍼
RibbonG3CoolHyper	쿨리본하이퍼
RibbonG3CoolMaster	쿨리본마스터
RibbonG3Beauty	뷰티리본 (G3)
RibbonG3BeautySuper	뷰티리본슈퍼
RibbonG3BeautyHyper	뷰티리본하이퍼
RibbonG3BeautyMaster	뷰티리본마스터
RibbonG3Cute	큐트리본 (G3)
RibbonG3CuteSuper	큐트리본슈퍼
RibbonG3CuteHyper	큐트리본하이퍼
RibbonG3CuteMaster	큐트리본마스터
RibbonG3Smart	지니어스리본 (G3)
RibbonG3SmartSuper	지니어스리본슈퍼
RibbonG3SmartHyper	지니어스리본하이퍼
RibbonG3SmartMaster	지니어스리본마스터
RibbonG3Tough	파워풀리본 (G3)
RibbonG3ToughSuper	파워풀리본슈퍼
RibbonG3ToughHyper	파워풀리본하이퍼
RibbonG3ToughMaster	파워풀리본마스터
RibbonG4Cool	쿨리본 (G4)
RibbonG4CoolGreat	쿨리본그레이트
RibbonG4CoolUltra	쿨리본울트라
RibbonG4CoolMaster	쿨리본마스터
RibbonG4Beauty	뷰티리본 (G4)
RibbonG4BeautyGreat	뷰티리본그레이트
RibbonG4BeautyUltra	뷰티리본울트라
RibbonG4BeautyMaster	뷰티리본마스터
RibbonG4Cute	큐트리본 (G4)
RibbonG4CuteGreat	큐트리본그레이트
RibbonG4CuteUltra	큐트리본울트라
RibbonG4CuteMaster	큐트리본마스터
RibbonG4Smart	지니어스리본 (G4)
RibbonG4SmartGreat	지니어스리본그레이트
RibbonG4SmartUltra	지니어스리본울트라
RibbonG4SmartMaster	지니어스리본마스터
RibbonG4Tough	파워풀리본 (G4)
RibbonG4ToughGreat	파워풀리본그레이트
RibbonG4ToughUltra	파워풀리본울트라
RibbonG4ToughMaster	파워풀리본마스터
RibbonWinning	위닝리본
RibbonVictory	빅토리리본
RibbonAbility	어빌리티리본
RibbonAbilityGreat	그레이트어빌리티리본
RibbonAbilityDouble	더블어빌리티리본
RibbonAbilityMulti	멀티어빌리티리본
RibbonAbilityPair	페어어빌리티리본
RibbonAbilityWorld	월드어빌리티리본
RibbonCountG3Cool	쿨리본
RibbonCountG3Beauty	뷰티리본
RibbonCountG3Cute	큐트리본
RibbonCountG3Smart	지니어스리본
RibbonCountG3Tough	파워풀리본
RibbonChampionAlola	알로라챔피언리본
RibbonBattleRoyale	로열마스터리본
RibbonBattleTreeGreat	그레이트트리리본
RibbonBattleTreeMaster	마스터트리리본
RibbonChampionGalar	가라르챔피언리본
RibbonTowerMaster	마스터타워리본
RibbonMasterRank	마스터랭크리본
RibbonMarkLunchtime	정오의증표
RibbonMarkSleepyTime	자정의증표
RibbonMarkDusk	황혼의증표
RibbonMarkDawn	새벽의증표
RibbonMarkCloudy	흐림의증표
RibbonMarkRainy	강우의증표
RibbonMarkStormy	우레의증표
RibbonMarkSnowy	강설의증표
RibbonMarkBlizzard	폭설의증표
RibbonMarkDry	건조의증표
RibbonMarkSandstorm	모래먼지의증표
RibbonMarkMisty	짙은안개의증표
RibbonMarkDestiny	운명의증표
RibbonMarkFishing	낚아올린증표
RibbonMarkCurry	카레의증표
RibbonMarkUncommon	가끔보는증표
RibbonMarkRare	본적없는증표
RibbonMarkRowdy	장난꾸러기증표
RibbonMarkAbsentMinded	촐랑거리는증표
RibbonMarkJittery	긴장의증표
RibbonMarkExcited	기대의증표
RibbonMarkCharismatic	카리스마의증표
RibbonMarkCalmness	냉정의증표
RibbonMarkIntense	정열의증표
RibbonMarkZonedOut	방심의증표
RibbonMarkJoyful	다행의증표
RibbonMarkAngry	분노의증표
RibbonMarkSmiley	미소의증표
RibbonMarkTeary	비통의증표
RibbonMarkUpbeat	쾌조의증표
RibbonMarkPeeved	격렬의증표
RibbonMarkIntellectual	이성의증표
RibbonMarkFerocious	본능의증표
RibbonMarkCrafty	교활의증표
RibbonMarkScowling	두려움의증표
RibbonMarkKindly	상냥함의증표
RibbonMarkFlustered	동요의증표
RibbonMarkPumpedUp	고양의증표
RibbonMarkZeroEnergy	권태의증표
RibbonMarkPrideful	자신의증표
RibbonMarkUnsure	불신의증표
RibbonMarkHumble	순박의증표
RibbonMarkThorny	불순의증표
RibbonMarkVigor	기력의증표
RibbonMarkSlump	피곤의증표
RibbonHisui	Hisui
RibbonTwinklingStar	트윙클스타리본
RibbonChampionPaldea	팔데아챔피언리본
RibbonMarkJumbo	커다란증표
RibbonMarkMini	조그만증표
RibbonMarkItemfinder	습득의증표
RibbonMarkPartner	파트너의증표
RibbonMarkGourmand	미식가의증표
RibbonOnceInALifetime	천재일우리본
RibbonMarkAlpha	우두머리의증표
RibbonMarkMightiest	최강의증표
RibbonMarkTitan	주인의증표